Hershel's	Delightful	Cattle	Farm
The	Free-Range	Livestock	Pastures
Ned's	Beefy	Bovine	Meadow
Luke's	Hardy	Meat	Plains
Macdonald's	Nutritional	Vegetable	Estate
Maggie's	Healthy	Wheat	Harvesters
Pleasantly	Digestible	Fish	Alliance
Scarecrow's	Sustainable	Potato	Inc.
Dwight's	Delicious	Chicken	Friends
Patricia's	Delectable	Poultry	Family
Porky's	Tasty	Food	Cooperative
Foxwood's	Divine	Swine	Society
Uncle Henry's	Spooky	Beast	Range
Ruth's	Scrumptious	Lamb	Company
Outstanding Fields	Farm
Amaizeing 	Crops
Blue Legume	Meadow
Farmageddon	Pastures
Quite Fowl
Udder Brilliance
High Steaks
