Oak's	Trusty	Grove	Family
Bunyan's	Worthy	Timber	Choppers
Linden's	Excellent	Forest	Mill
Maple's	Good	Wood	Alliance
The 	Quality	Woodland	Cooperative
Theresa Green's	Impressive	Jungle	Union
Willow's	Decent	Plantation	Alliance
Woody's	Awesome	Plank	Association
Fairly	Majestic	Log	World
Palmer's	Adequate	Furniture	Organisation
Big Joe's	Fine	Lumber	Friends
Forestry	Mill
Flooring	Union
Kitchen Cabinet	Carpentry
Park Bench	Woodworkers
Grizzly	Loggers
Stumpy Lumberjacks
Two Tree Hill
Life's a Birch
Fir Sure
Holy Treenity
Barking Mad
